[START=CTDL SETTINGS]
g:categories	"1"
g:list_view	"1"
g:sort_order	"_deadline"
g:todo_author	"0"
g:show_completed_date	"1"
g:show_deadline	"1"
g:show_progress	"1"
g:admin_bar	"1"
g:wysiwyg	"1"
g:autop	"1"
g:post_planner	"0"
a:date_format	"d\/M\/Y"
a:priority_0	"High"
a:priority_1	"Normal"
a:priority_2	"Low"
a:show_id	"1"
a:show_date_added	"1"
a:assign	"0"
a:show_only_assigned	"0"
a:user_roles	"administrator, editor, author, contributor, subscriber"
a:email_assigned	"1"
a:email_category	"1"
a:email_show_assigned_by	"1"
a:email_from	"WordPress"
a:email_subject	"A to-do list item has been assigned to you"
a:email_text	"The following item has been assigned to you:"
p:view_capability	"read"
p:complete_capability	"read"
p:add_capability	"edit_posts"
p:edit_capability	"edit_posts"
p:assign_capability	"manage_options"
p:view_all_assigned_capability	"manage_options"
p:delete_capability	"manage_options"
p:purge_capability	"manage_options"
p:add_cat_capability	"manage_options"
[STOP=CTDL SETTINGS]